@@@@@@@@@@@@@@@@@@@@@@@@@@@@@@@@
@@@@@@@@@@@@@@@@@@@@@@@@@@@@@@@@
@@@@                        @@@@
@@@@                        @@@@
@@@@      @@@@@@@@@@@@@@@@@@@@@@
@@@@      @@@@@@@@@@@@@@@@@@@@@@
@@@@      @@@@@@@@@@@@@@@@@@@@@@
@@@@                        @@@@
@@@@                        @@@@
@@@@      @@@@@@@@@@@@@@@@@@@@@@
@@@@      @@@@@@@@@@@@@@@@@@@@@@
@@@@      @@@@@@@@@@@@@@@@@@@@@@
@@@@      @@@@@@@@@@@@@@@@@@@@@@
@@@@      @@@@@@@@@@@@@@@@@@@@@@
@@@@      @@@@@@@@@@@@@@@@@@@@@@
@@@@      @@@@@@@@@@@@@@@@@@@@@@
@@@@@@@@@@@@@@@@@@@@@@@@@@@@@@@@
@@@@@@@@@@@@@@@@@@@@@@@@@@@@@@@@